Castanha Shüta	Lycée du Pays de Soule
The Saving Family	Lycée du Pays de Soule
Réunion Basci-Béarnais	Lycée du Pays de Soule
Playbot	Lycée International de Valbonne
BRUH	Lycée International de Valbonne
Robot Jul	Lycée International de Valbonne
Wizzbot	Lycée International de Valbonne
Green Studio	Lycée International de Valbonne
Blank	Lycée International de Valbonne
Bang Schnecke	Lycée International de Valbonne
Gear	Lycée International de Valbonne
Robot55 Team	Collège International de Valbonne
Robot56 Team	Collège International de Valbonne
PoweRobot	Lycée St Joseph
2ndC1	Lycée St Joseph
SEJO Haspatech	Lycée St Joseph
EuskalRobota	Lycée St Joseph
2ndSTGA	Lycée St Joseph
Les Nerissons	Collège St Philippe Neri
MEDITES	Collège Emile Roux
Club Rob	Collège Emile Roux
